2,2,2,2,2,2,2,2,2,2,5,4,4,4,4,4,5,5
2,2,2,2,2,2,2,2,2,2,5,4,4,4,4,4,5,5
2,2,2,2,2,2,2,2,2,2,5,4,4,4,4,4,5,5
2,2,2,2,2,2,2,2,2,2,5,4,4,4,4,4,4,5
2,2,2,2,2,2,2,2,2,2,5,5,4,4,4,4,4,5
3,3,3,3,3,3,3,2,2,2,2,5,4,4,5,5,5,2
3,3,3,3,3,3,3,2,2,2,2,2,5,5,2,2,2,2
3,3,3,3,3,3,3,2,2,2,2,2,2,2,2,2,2,2
3,3,3,3,3,3,3,2,2,2,2,2,2,2,2,2,2,2
3,3,3,3,3,3,3,3,3,3,3,3,3,3,3,3,3,3
3,3,3,3,3,3,2,2,2,2,2,2,2,2,2,2,2,2
1